#.#....#.#
#....#...#
#.#...#..#
#..#.#...#
#.....#..#
#.##.....#
\robot 1 0
\robot 1 5
\robot 8 0
\robot 8 5
